{
  "width": 40,
  "height": 30,
  "legend": {
    "#": "rock",
    ".": "grass",
    ",": "soil",
    "*": "crystal",
    "G": "great_crystal",
    "H": "habitat_wall",
    "D": "habitat_door",
    "T": "terminal",
    "P": "landing_pad",
    "S": "shipping_pod",
    "B": "building",
    "o": "path"
  },
  "player_start": {
    "x": 3,
    "y": 7
  },
  "rows": [
    "########################################",
    "#......................................#",
    "#.HHH........................PPPPPPPPP.#",
    "#.HHH.........##........*....PPPPPPPPP.#",
    "#.HHH........................PPPPSPPPP.#",
    "#.HHH...............#........PPPPPPPPP.#",
    "#.HDHT.......................PPPPPPPPP.#",
    "#................*.....................#",
    "#......................................#",
    "#......................................#",
    "#...,,,,,,,,,,,,,,,,,,,,......*........#",
    "#...,,,,,,,,,,,,,,,,,,,,...*...........#",
    "#...,,,,,,,,,,,,,,,,,,,,..G.........#..#",
    "#...,,,,,,,,,,,,,,,,,,,,...............#",
    "#...,,,,,,,,,,,,,,,,,,,,...*...........#",
    "#..#,,,,,,,,,,,,,,,,,,,,...............#",
    "#...,,,,,,,,,,,,,,,,,,,,...............#",
    "#...,,,,,,,,,,,,,,,,,,,,...............#",
    "#...,,,,,,,,,,,,,,,,,,,,...............#",
    "#...,,,,,,,,,,,,,,,,,,,,...............#",
    "#.#........................oooooooooooo#",
    "#...........................BBBBooBBBB.#",
    "#...........*............#..BBBBooBBBB.#",
    "#...........................BBBBooBBBB.#",
    "#.....*....................oooooooooooo#",
    "#.........##................BBBBooBBBB.#",
    "#...................#.......BBBBooBBBB.#",
    "#...........................BBBBooBBBB.#",
    "#......................................#",
    "########################################"
  ]
}