{
  "width": 40,
  "height": 30,
  "legend": {
    "#": "rock",
    ".": "grass",
    ",": "soil",
    "*": "crystal",
    "G": "great_crystal",
    "H": "habitat_wall",
    "D": "habitat_door",
    "T": "terminal",
    "P": "landing_pad",
    "S": "shipping_pod",
    "B": "building",
    "o": "path",
    "M": "mine_entrance"
  },
  "player_start": {
    "x": 3,
    "y": 7
  },
  "buildings": [
    {
      "x": 34,
      "y": 21,
      "w": 4,
      "h": 3,
      "image": "bar"
    },
    {
      "x": 28,
      "y": 25,
      "w": 4,
      "h": 3,
      "image": "shop"
    }
  ],
  "rows": [
    "########################################",
    "#......................................#",
    "#.HHH........................PPPPPPPPP.#",
    "#.HHH.........##........*....PPPPPPPPP.#",
    "#.HHH........................PPPPSPPPP.#",
    "#.HHH...............#........PPPPPPPPP.#",
    "#.HDHT.......................PPPPPPPPP.#",
    "#................*.....................#",
    "#......................................#",
    "#......................................#",
    "#...,,,,,,,,,,,,,,,,,,,,......*........#",
    "#...,,,,,,,,,,,,,,,,,,,,...*...........#",
    "#...,,,,,,,,,,,,,,,,,,,,..G.........#..#",
    "#...,,,,,,,,,,,,,,,,,,,,...............#",
    "#...,,,,,,,,,,,,,,,,,,,,...*...........#",
    "#..#,,,,,,,,,,,,,,,,,,,,...............#",
    "#...,,,,,,,,,,,,,,,,,,,,...............#",
    "#...,,,,,,,,,,,,,,,,,,,,...............#",
    "#...,,,,,,,,,,,,,,,,,,,,...............#",
    "#...,,,,,,,,,,,,,,,,,,,,...............#",
    "#.#........................oooooooooooo#",
    "#...........................ooooooBBBB.#",
    "#...........M............#..o*ooooBBBB.#",
    "#...........................ooooooBBBB.#",
    "#.....*....................oooooooooooo#",
    "#.........##................BBBBoooooo.#",
    "#...................#.......BBBBoooToo.#",
    "#...........................BBBBoooooo.#",
    "#......................................#",
    "########################################"
  ]
}